+=----+---+
|     |   |
+-+ | +-- +
| | |     |
| | +-----+
| |       |
| | +-+ | |
|   |   | |
| +-+---+ +
| |     | |
| | --+ | +
| |   |   |
| +-+ +-- +
|   | |   |
+---+=+---+
